#domain
hospital
#levelname
SABoxes
#colors
red: 0, A
#initial
++++++++++++
+       0+ +
+ ++++++++ +
+    A     +
+A++++++++ +
+A+        +
++++++++++++
#goal
++++++++++++
+       A+A+
+ ++++++++A+
+          +
+ ++++++++ +
+ +        +
++++++++++++
#end