#domain
hospital
#levelname
SAbongu
#colors
blue: 0, A, B, C, D, E
#initial
+++++++++++++++++
+0 C            +
+    D  +++++++++
+  A   D        +
+     E +++++++++
+        B      +
+++++++++++++++++
#goal
+++++++++++++++++
+               +
+       +++++++++
+       E DC A B+
+       +++++++++
+               +
+++++++++++++++++
#end