#domain
hospital
#levelname
SABoxes
#colors
red: 0, A, B, C, D
#initial
++++++++++++
+       0+ +
+ ++++++++ +
+          +
+C++++++++B+
+A+        +
++++++++++++
#goal
++++++++++++
+       A+C+
+ ++++++++ +
+          +
+ ++++++++ +
+ +B       +
++++++++++++
#end