#domain
hospital
#levelname
SAbongu
#colors
blue: 0, A, B, C, D, E
#initial
+++++++++++++++++
+               +
+       +++++++++
+       C 0B   A+
+       +++++++++
+               +
+++++++++++++++++
#goal
+++++++++++++++++
+               +
+       +++++++++
+           ACB +
+       +++++++++
+               +
+++++++++++++++++
#end